XXXXXXXXX
X  X    X
X       XX
X     X XXXXXX
X X X XOX  XXX
X XXX X      X
X  X  X     @X
X    XXoX  XXX
o  XbXXlXXXXXX
X  X  XXX
XXXXXXX
